{
    "map": [
        "1","1","1","1","1","1","1","1","1","1",
        "1","0","2","2","2","0","0","2","0","1",
        "1","0","1","1","1","0","1","1","0","1",
        "1","0","0","0","2","0","0","0","0","1",
        "1","0","0","0","1","1","0","0","0","1",
        "1","0","0","0","1","1","0","0","0","1",
        "1","0","0","0","0","1","0","0","0","1",
        "1","0","0","0","0","1","0","0","0","1",
        "1","0","0","0","0","0","0","0","0","1",
        "1","1","1","1","1","1","1","1","1","1"
    ],
    "width": 10,
    "height": 10,
    "players": {
        "1": {
            "x": 1,
            "y": 1
        },
        "2": {
            "x": 1,
            "y": 9
        },
        "3": {
            "x": 9,
            "y": 1
        },
        "4": {
            "x": 9,
            "y": 9
        }
    },
    "keys": {
        "wall_key": "1",
        "floor_key": "0",
        "breakable_key": "2"
    }
}